1111111111111111111111111111111111
10P0000010000000001000000000000001
1000000010001110001001011111111111
1000000010000C10001001C10000000001
1000000011111110001001110000000001
1000C00000000000001000000000000001
10000000000000000C1000000000000001
1000000011111111111000000000000001
1000000000000000000000000111111111
10000000000000000000000001C010C001
1000000011111111111000000100100001
1111100000000000C01000000000000001
1000000000000000001000000000000001
1000000011111111111000011111111111
11111000000000000C1000000000000001
10000000000000000010000000000000E1
1111111111111111111111111111111111