111111111111111111111111111111111111111111111111111
1110000000000P0000000000000000000000000000000011111
111000C0000C000011000000000000C00000000000000011111
111000C000000000110000000000000C0000000000000011111
111000C000000000110000000000000C0000000000000011111
111000C000000000110000000000000C0000000000000011111
111000C000000000110000000000000C0000000000000011111
111000C000000000110000000000000C0000000000000011111
111000C000000000110000000000000C0000000000000011111
111000C000000000110000000000000C0000000000000011111
111000C000000000110000000000000C0000000000000011111
111000C000000000110000000000000C0000000000000011111
111000C000000000000000000000000C0000000000000011111
111000C000000000000000000000000C0000000000000011111
111000C000000000000000000000000C0000000000000011111
111000C000000000000000000000000C0000000000000011111
111000C000000000000000000000000C0000000000000011111
111000C000000000000000000000000C0000000000000011111
111000C000000000000000000000000C0000000000000011111
111000C000000000000000000000000C00000000000E0011111
111111111111111111111111111111111111111111111111111