1111111111111
1P00010C000C1
100C000011111
10C001000C001
1111111111111