11111111111111111111111111111111111111111111111111111
1P0E0111001111111111111111111111111111111111111111111
10C00000C00000000000000000000000000000000000000000011
11111111111111111111111111111111111111111111111111111