1111111111111
1P0C011100111
10C001000E001
1111111111111