1111111111111
1P0E011100111
10C001000C001
1111111111111